111111111
10P000001
10C000001
10C00E001
10C000001
100000001
111111111
