1111111111111111111111
1000000000000000000001
10000000C0000000000001
1000000E000000000C0001
1PC0000000000000011101
10000000000B0000010101
1111111111111111111111