111111111111111111
10P000000000000001
10C000000000000001
10C00E000000000001
10C000000000000001
100000000000000001
111111111111111111
