1111111
1E100B1
1P100B1
1BC0001
1111111